 ####### ########### ########### #######
#.......#...........#...........#.......#
#.#####.#.#######.#.#######.###.#.#.###.#
#.....#...#.......#.....#...#...#.#...#.#
 ####.#####.###### ####.#.#####.## ##.#.#
#...#...#...#.....#.....#.....#...#...#.#
#.#.#####.###.###.#####.#####.###.#.###.#
#.#.....#.......#.#...#...#...#.#...#.#.#
#.#####.#########.#.#.###.#.###.#####.#.#
#.#...............#.#.#.#...#.........#.#
#.###############.#.#.#.#####.#.#####.#.#
#.........#.......#.#.#.......#.....#.#.#
#.#######.###.#####.#.#.#####.#####.#.#.#
#...#...#...#.#.....#.#.#...#...#...#.#.#
 ##.#.#.###.###.#####.###.#.#####.#####.#
#...#.#...#.....#...#.....#.....#.......#
#.###.#.#.#########.###########.#.######
#.#...#.#.#...#.........#.....#.#.#.....#
#.#####.#.#.#.###.#####.#####.#.###.###.#
#.......#...#.....#.#...#...#.#.#...#...#
#.#################.#.###.#.#.#.#.###.#.#
#.#.......#...#...#.#.....#...#...#...#.#
#.#.#####.#.#.#.#.#.#####.#####.###.###.#
#.#...#.#...#...#.#.....#.#...#...#...#.#
#.###.#.#### ####.#####.###.#.#######.#.#
#.#.#.......#.........#.....#.......#.#.#
#.#.#######.#.#######.#############.#.##
#...#...#...#.#.......#.......#...#.#...#
 ##.#.#.#.###.#.#######.###.#.#.###.###.#
#.....#.#.#.#.#...#.....#...#...#...#...#
 ########.#.#.#####.#####.#######.###.#.#
#...#.....#.#.....#.....#.........#...#.#
#.#.#.#####.#####.#####.###########.###.#
#.#...#.........#.....#.....#.......#...#
#.#######.###.#.###.#######.#.#.#.######
#.......#...#.#...#.......#.#.#.#.#.....#
 ######.#####.###.#####.###.#.#.###.###.#
#O#...#.......#.#.#...#.....#.#.......#.#
#.#.#.#########.#.###.#################.#
#...#...................................#
 ### ###################################